Afro-Eurasia 	Afro-Eurasian 	Afro-Eurasians
Africa 	African 	Africans
Eurasia 	Eurasian 	Eurasians
Asia 	Asian 	Asians
Middle East 	Middle Eastern 	Middle Easterners
Europe 	European 	Europeans
Americas 	Americana 	Americansa
North America 	North American 	North Americans
Caribbean 	Caribbean 	Caribbeans
West Indies 	West Indian 	West Indians
Central America 	Central American 	Central Americans
Northern America 	Northern American 	Northern Americans
South America 	South American 	South Americans
Antarctica 	Antarctic 	Antarcticans
Oceania 	Oceanian 	Oceanians
Australasia 	Australasian 	Australasians
Australiab 	Australianb 	Australiansb
Zealandia 	Zealandian 	Zealandians
Pacific Islands 	Pacific Islands 	Pacific Islanders
Australian Capital Territory 	Canberran 	Canberrans 	"Inlanders", "Round Abouters", "Canberries", "Pollies"
New South Wales 	New South Welsh 	New South Welshmen 	"Waratahs", "Cockroaches", "Blues"
Northern Territory 	Northern Territory 	Territorians 	"Top Enders", "Ex-pats"
Queensland 	Queensland 	Queenslanders 	"Banana Benders", "Cane Toads", "Maroons"
South Australia 	South Australian 	South Australians 	"Crow Eaters"
Tasmania 	Tasmanian 	Tasmanians 	"Apple Eaters", "Taswegians", "Tazzies"
Victoria 	Victorian 	Victorians 	"Vics", "Mexicans"
Western Australia 	Western Australian 	Western Australians 	"Sandgropers", "Westralians"
Alberta (Province) 	Albertan 	Albertans
British Columbia (Province) 	British Columbian  ("B.C.") 	British Columbians 	"B.C.ers"
Manitoba (Province) 	Manitoban 	Manitobans 	"Tobans"
New Brunswick (Province) 	New Brunswick 	New Brunswickers
Newfoundland and Labrador (Province) 	Newfoundland and Labrador 	Newfoundlanders, Labradorians 	"Newfies"
Northwest Territories (Territory) 	Northwest Territorian   ("N.W.T.") 	Northwest Territorians 	"N.W.T.ers"
Nunavut (Territory) 	Nunavut 	Nunavummiut (sing. Nunavummiuq)
Nova Scotia (Province) 	Nova Scotian 	Nova Scotians 	"Bluenosers"
Ontario (Province) 	Ontario 	Ontarians
Prince Edward Island (Province) 	Prince Edward Island, P.E.I., Island 	Islanders
Quebec (Province) 	Quebec
French: Québécois (masc.), Québécoise (fem.) 	Quebeckers, Quebecers
French: Québécois 	French: "Habitants"
Saskatchewan (Province) 	Saskatchewan 	Saskatchewanians 	"Flat-Landers"
Yukon (Territory) 	Yukon 	Yukoners 	"Sourdoughs"
Baden-Württemberg (federated state) 			 
Bavaria (federated state) 	Bavarian 	Bavarians 	German: Bazis
Berlin (federated state) 		Berliners 	
Brandenburg (federated state) 	Brandenburgish 	Brandenburgers 	
Franconia 	Franconian 	Franconians 	
Free Hanseatic City of Bremen 			
Free and Hanseatic City of Hamburg 	Hamburgish 	Hamburgians 	
Hannover (ancient German state) 	Hanoverian 	Hanoverians 	
Hesse (federated state) 	Hessian 	Hessians 	
Lower Saxony (federated state) 	Lower Saxon 	Lower Saxons 	
Mecklenburg-Western Pomerania (federated state) 			
North Rhine-Westphalia (federated state) 	North Rhine - Westphalian 	North Rhine - Westphalians 	
Pomerania (ancient German territory) 	Pomeranian 	Pomeranians 	
Prussia (ancient German state) 	Prussian 	Prussians 	Bavarian: Saupreiss'n
Rhineland (area) 	Rhenish 	Rhinelanders 	
Rhineland-Palatinate (federated state) 			
Saarland (federated state) 		Saarlanders 	
Saxony (federated state) 	Saxon 	Saxons 	
Saxony-Anhalt (federated state) 			
Silesia (ancient German territory) 	Silesian 	Silesians 	
Schleswig-Holstein (federated state) 			
Swabia (South German area and ancient territory) 	Swabian 	Swabians 	
Thuringia (federated state) 	Thuringian 	Thuringians 
Andaman and Nicobar Islands 	[1] Andamanese[1]
Nicobarese[1] 	Andamanese
Nicobarese
Andhra Pradesh 	Andhraite 	Andhraites 	Teluguvaaru
Arunachal Pradesh 	Arunachali 	Arunachalis
Assam 	Assamese[1] 	Assamese
Bihar 	Bihari[1] 	Biharis
Chandigarh 	Chandigarhi 	Chandigarhis
Chhattisgarh 	Chhattisgarhi 	Chhattisgarhis
Dadra and Nagar Haveli 	Dadran
Nagar Havelian 	Dadrans
Nagar Havelians
Daman and Diu 	Damanese
Diuese 	Damanese
Diuese
Delhi 	Delhiite, Delhian 	Delhiites, Delhians
Goa 	Goan,[1] Goenkar 	Goans, Goenkars
Gujarat 	Gujarati[1] 	Gujaratis
Haryana 	Haryanvi 	Haryanvis 	_
Himachal Pradesh 	Himachali 	Himachalis
Jammu and Kashmir 	Jammu
Kashmiri[1] 	Jammuite
Kashimiris 	_
Jharkhand 	Jharkhandi 	Jharkhandis
Karnataka 	Karnatakan, Canarese[1] [1] 	Karnatakans, Canarese, Kannadiga 	Carnatic
Kerala 	Keralite 	Keralites 	Malayalis
Lakshadweep (Laccadives) 	Laccadivian 	Laccadivians 	
Madhya Pradesh 	Madhya Pradeshi 	Madhya Pradeshis
Maharashtra 	Maharashtrian[1] 	Maharashtrians 	Marathi
Manipur 	Manipuri[1] 	Manipuris
Meghalaya 	Meghalayan 	Meghalayans
Mizoram 	Mizo[1] 	Mizos
Nagaland 	Naga,[1] Nagalandese 	Nagas
Odisha 	Odia[1] (Odia) [of the people]
Odishan (Orissan) [of the state]
Odissi (Orissi)[1] 	Odias (Odias)
Odishans (Orissans) 	_
Puducherry (formerly Pondicherry) 	Pondicherrian 	Pondicherrians 	_
Punjab 	Punjabi[1] 	Punjabis
Rajasthan 	Rajasthani[1] 	Rajasthanis
Sikkim 	Sikkimese[1] 	Sikkimese
Tamil Nadu 	Tamil,[1] Tamilian 	Tamils, Tamilians
Telangana 	Telanganite 	Telanganites
Tripura 	Tripuri, Tripuran 	Tripuris, Tripurans
Uttar Pradesh 	Uttar Pradeshi, Hindi 	Uttar Pradeshis
Uttarakhand 	Uttarakhandi 	Uttarakhandis
West Bengal 	(West) Bengali,[1] (West) Bengalese,[1] Bangla[1] 	(West) Bengalis, (West) Bengalese, Banglas 
Alabama 	Alabamian 	Alabaman[2][3]
Alaska 	Alaskan 	
American Samoa† 		American Samoan
Arizona 	Arizonan 	
Arkansas 	Arkansan 	Arkansawyer,[4] Arkie[5]
California 	Californian 	Californio (archaic)
Colorado 	Coloradan 	Coloradoan (archaic)[6][7]
Connecticut 	Connecticuter 	Connecticotian,[8] Connecticutensian,[8] Nutmeg,[8] Nutmegger[8]
Delaware 	Delawarean 	Blue Hen's Chicken,[9] Muskrat[9]
District of Columbia† 		Washingtonian (see also nicknames of people of Washington state)
Florida 	Floridian 	Alligator,[10] Cracker,[11] Fly-Up-the-Creek[10]
Georgia (U.S. state) Georgia 	Georgian 	Buzzard, Cracker, Goober-grabber[12]
Guam† 		Guamanian
Hawaii 	Hawaii resident 	Islander,[13] Kamaʻāina. The Associated Press Stylebook restricts use of "Hawaiian" to people of Native Hawaiian descent.[14]
Idaho 	Idahoan 	Fortune Seekers[15]
Illinois 	Illinoisan 	Illinoisian, Illinoian, Flatlander,[16] Sucker, Sand-hiller, Egyptian[17]
Indiana 	Hoosier 	Indianan (former GPO demonym replaced by Hoosier in 2016),[1] Indianian (archaic)[18]
Iowa 	Iowan 	Hawkeye[19]
Kansas 	Kansan 	Sunflower, Jayhawker, Grasshopper[20]
Kentucky 	Kentuckian 	Corncracker[21]
Louisiana 	Louisianian 	(French: Louisianais,Spanish: Luisiano)
Maine 	Mainer 	Down Easter or Downeaster,[22] Mainiac[23]
Maryland 	Marylander 	
Massachusetts 	Massachusettsan 	Bay Stater (official term used by state government),[24] Massachusettsian,[25] Massachusite,[26][27] Masshole (derogatory[28] as an exonym; however, it can be affectionate when applied as an endonym[29])
Michigan 	Michiganian 	Michigander,[30] Wolverine,[31][32] Michiganite, Yooper/Troll (for residents of the Upper Peninsula and Lower Peninsula, respectively),[33] Michigoose (used specifically for female residents, as a play on "Michigander")[33]
Minnesota 	Minnesotan 	Gopher
Mississippi 	Mississippian 	
Missouri 	Missourian 	
Montana 	Montanan 	
Nebraska 	Nebraskan 	Bugeaters or Cornhuskers [34]
Nevada 	Nevadan 	
New Hampshire 	New Hampshirite 	New Hampshireman or New Hampshirewoman[35]
New Jersey 	New Jerseyan 	Jerseyite, New Jerseyite
New Mexico 	New Mexican 	Spanish: Neomexicano, Neomejicano[36]
New York (state) New York 	New Yorker 	Knickerbocker[37][38]
North Carolina 	North Carolinian 	Tar Heel, Tar Boiler,[39]
North Dakota 	North Dakotan 	
Northern Mariana Islands† 		Mariana Islander
Ohio 	Ohioan 	Buckeye,[40] Ohian (obsolete)[41]
Oklahoma 	Oklahoman 	Okie,[42] Sooner[43]
Oregon 	Oregonian 	
Pennsylvania 	Pennsylvanian 	Pennamite,[44] Keystoner
Puerto Rico† 	Puerto Rican 	Boricua[45]
Rhode Island 	Rhode Islander 	Rhodean, Swamp Yankee[46]
South Carolina 	South Carolinian 	Sandlapper[47]
South Dakota 	South Dakotan 	
Tennessee 	Tennessean 	Volunteer, Big Bender, Butternut[48]
Texas 	Texan 	Texian (Anglo-Texan - historical),[49] Tejano (Hispano-Texan), Texican (archaic)
Utah 	Utahn 	Utahan
Vermont 	Vermonter 	
Virginia 	Virginian 	
United States Virgin Islands Virgin Islands† 		Virgin Islander
Washington (state) Washington 	Washingtonian 	
West Virginia 	West Virginian 	
Wisconsin 	Wisconsinite 	Badger,[50] Cheesehead[51][52]
Wyoming 	Wyomingite 	Wyomese[53]
Johor 	Johorean 	Johoreans 	Southerners
Kedah 	Kedahan 	Kedahans
Kelantan 	Kelantanese 	Kelantanese 	East Coasters
Kuala Lumpur 	Kuala Lumpurian 	Kuala Lumpurians 	Federal Territorians, KL-ites
Labuan 	Labuanese 	Labuanese 	Federal Territorians
Malacca 	Malaccan 	Malaccans
Negeri Sembilan 	Negeri Sembilanese 	Negeri Sembilanese 	Negrians
Pahang 	Pahangite 	Pahangites
Penang 	Penangite 	Penangites 	Penang Islanders
Perak 	Perakian 	Perakians
Perlis 	Perlisian 	Perlisians
Putrajaya 	Putrajayan 	Putrajayans 	Federal Territorians
Sabah 	Sabahan 	Sabahans 	Borneoans
Sarawak 	Sarawakian 	Sarawakians 	Borneoans
Selangor 	Selangorean 	Selangoreans
Terengganu 	Terengganuan 	Terengganuans 	East Coasters
Peninsular (West) Malaysia 	Peninsular, West Malaysian 	Peninsularians, West Malaysians 	Malayans
East Malaysia 	East Malaysian 	East Malaysians 	Borneoans
States of Mexico
Main article: States of Mexico
Federal entity 	Adjective 	Demonym
	colloquial
Aguascalientes 	Hydrocalid 	Hidrocálido/-a 	
Baja California 	Lower Californian 	Bajacaliforniano/-a 	
Baja California Sur 	South Lower Californian 	Sudcaliforniano/-a 	
Campeche 	Campechan 	Campechano/-a 	
Chiapas 	Chiapan 	Chiapaneco/-a 	
Chihuahua 	Chihuahuan 	Chihuahuense 	
Coahuila de Zaragoza 	Coahuilan 	Coahuilense 	
Colima 	Colimean 	Colimense 	
Durango 	Durangolese 	Duranguense 	
Guanajuato 	Guanajuatean 	Guanajuatense 	
Guerrero 	Guerreran 	Guerrerense 	
Hidalgo 	Hidalgolese 	Hidalguense 	
Jalisco 	Jaliscan 	Jalisciense 	"Jalisquillo"
México (state) 	Mexican 	Mexiquense 	
Ciudad de México (Mexico City) 		Defeño/-a 	"Chilango"
Michoacán de Ocampo 	Michoacanese 	Michoacano/-a 	
Morelos 	Morelese 	Morelense 	
Nayarit 	Nayarita 	Nayarita 	
Nuevo León 	New-leonese 	Neoleonés/Neoleonense 	
Oaxaca 	Oaxacan 	Oaxaqueño/-a 	"Oaxaco"
Puebla 	Pueblan/Poblano 	Poblano/-a 	
Querétaro de Arteaga 	Queretan 	Queretano/-a 	
Quintana Roo 	Quintanaroan 	Quintanarroense 	
San Luis Potosí 	Potosinian 	Potosino/-a 	
Sinaloa 	Sinaloan 	Sinaloense 	
Sonora 	Sonoran 	Sonorense 	
Tabasco 	Tabascan 	Tabasqueño/-a 	
Tamaulipas 	Tamaulipan 	Tamaulipeco/-a 	
Tlaxcala 	Tlaxcaltheque 	Tlaxcalteco/ -a 	
Veracruz de Ignacio de la Llave 	Veracruzan 	Veracruzano/-a 	
Yucatán 	Yucatheque 	Yucateco/-a 	
Zacatecas 	Zacatecan 	Zacatecano/-a
Abkhazia 	Abkhaz, Abkhazian 	Abkhazians
Afghanistan 	Afghan 	Afghans 	"Afghanis"
Åland Islands 	Åland Island 	Åland Islanders
Albania 	Albanian 	Albanians
Algeria 	Algerian 	Algerians
American Samoa 	American Samoan 	American Samoans
Andorra 	Andorran 	Andorrans
Angola 	Angolan 	Angolans
Anguilla 	Anguillan 	Anguillans
Antarctica[a] 	Antarctic 	Antarctic residents
Antigua and Barbuda 	Antiguan or Barbudan 	Antiguans or Barbudans
Argentina 	Argentinian[1] 	Argentines, Argentinians 	"Gauchos"
Armenia 	Armenian 	Armenians
Aruba 	Aruban 	Arubans
Australia 	Australian 	Australians 	"Aussies"
Austria 	Austrian 	Austrians
Azerbaijan 	Azerbaijani, Azeri 	Azerbaijanis, Azeris
Bahamas, The 	Bahamian 	Bahamians
Bahrain 	Bahraini 	Bahrainis
Bangladesh 	Bangladeshi 	Bangladeshis 	"Deshis", "Bengis", "Bennies", "Bengullies", "Bangalis", "Banglas", "Bengalis"
Barbados 	Barbadian 	Barbadians 	"Bajans"
Belarus 	Belarusian 	Belarusians
Belgium 	Belgian 	Belgians
Belize 	Belizean 	Belizeans
Benin 	Beninese, Beninois 	Beninese, Beninois
Bermuda 	Bermudian, Bermudan 	Bermudians, Bermudans 	"Onions"
Bhutan 	Bhutanese
Bolivia 	Bolivian 	Bolivians
Bonaire 	Bonaire 	Bonaire Dutch
Bosnia and Herzegovina 	Bosnian or Herzegovinian 	Bosnians or Herzegovinians
Botswana 	Motswana, Botswanan 	Motswana (sing., plural Batswana), Botswanans
Bouvet Island 	Bouvet Island 	none
Brazil 	Brazilian 	Brazilians 	
British Indian Ocean Territory 	BIOT 	British
Brunei 	Bruneian 	Bruneians
Bulgaria 	Bulgarian 	Bulgarians
Burkina Faso 	Burkinabé 	Burkinabè/Burkinabé
Burma[b] 	Burmese 	Burmese, Bamar
Burundi 	Burundian 	Burundians, Barundi
Cabo Verde[c] 	Cabo Verdean 	Cabo Verdeans
Cambodia 	Cambodian 	Cambodians
Cameroon 	Cameroonian 	Cameroonians
Canada 	Canadian 	Canadians 	"Canucks"
Cayman Islands 	Caymanian 	Caymanians
Central African Republic 	Central African 	Central Africans
Chad 	Chadian 	Chadians
Chile 	Chilean 	Chileans
China 	Chinese
Christmas Island 	Christmas Island 	Christmas Islanders
Cocos (Keeling) Islands 	Cocos Island 	Cocos Islanders
Colombia 	Colombian 	Colombians 	"Cafeteros"
Comoros 	Comoran, Comorian 	Comorans, Comorians
Congo, Democratic Republic of the 	Congolese
Congo, Republic of the
Cook Islands 	Cook Island 	Cook Islanders
Costa Rica 	Costa Rican 	Costa Ricans 	"Ticos"
Côte d'Ivoire[d] 	Ivorian 	Ivorians
Croatia 	Croatian 	Croatians, Croats
Cuba 	Cuban 	Cubans
Curaçao 	Curaçaoan 	Curaçaoans
Cyprus 	Cypriot 	Cypriots
Czech Republic 	Czech 	Czechs
Denmark 	Danish 	Danes
Djibouti 	Djiboutian 	Djiboutians
Dominica 	Dominican[e] 	Dominicans[e]
Dominican Republic 	Dominican[f] 	Dominicans[f] 	"Quisqueyanos"
East Timor[g] 	Timorese 	"Maubere"
Ecuador 	Ecuadorian 	Ecuadorians
Egypt 	Egyptian 	Egyptians
El Salvador 	Salvadoran 	Salvadorans 	"Guanacos"
Equatorial Guinea 	Equatorial Guinean, Equatoguinean 	Equatorial Guineans, Equatoguineans
Eritrea 	Eritrean 	Eritreans
Estonia 	Estonian 	Estonians
Eswatini (Swaziland)[h] 	Swazi, Swati 	Swazis
Ethiopia 	Ethiopian 	Ethiopians, Habesha
European Union[i] 	European[j] 	Europeans[j]
Falkland Islands 	Falkland Island 	Falkland Islanders 	"Belongers"
Faroe Islands 	Faroese
Fiji 	Fijian 	Fijians
Finland 	Finnish 	Finns
France 	French 	French, Frenchmen/Frenchwomen 	"Gauls"
French Guiana 	French Guianese
French Polynesia 	French Polynesian 	French Polynesians
French Southern Territories 	French Southern Territories 	French
Gabon 	Gabonese 	Gabonese, Gabonaise
Gambia, The 	Gambian 	Gambians
Georgia 	Georgian 	Georgians
Germany 	German 	Germans
Ghana 	Ghanaian 	Ghanaians
Gibraltar 	Gibraltar 	Gibraltarians 	"Llanitos"
Greece 	Greek, Hellenic 	Greeks, Hellenes
Greenland 	Greenlandic 	Greenlanders
Grenada 	Grenadian 	Grenadians
Guadeloupe 	Guadeloupe 	Guadeloupians, Guadeloupeans
Guam 	Guamanian 	Guamanians
Guatemala 	Guatemalan 	Guatemalans 	"Chapines"
Guernsey 	Channel Island 	Channel Islanders
Guinea 	Guinean 	Guineans
Guinea-Bissau 	Bissau-Guinean 	Bissau-Guineans
Guyana 	Guyanese
Haiti 	Haitian 	Haitians 	"Ayisyen"
Heard Island and McDonald Islands 	Heard Island or McDonald Islands 	none
Honduras 	Honduran 	Hondurans 	"Catrachos"
Hong Kong 	Hong Kong, Cantonese, Hong Konger 	Hongkongers, Hong Kongese 	"Hongkies", "Hongers",

Cantonese
Hungary 	Hungarian, Magyar 	Hungarians, Magyars
Iceland 	Icelandic 	Icelanders
India 	Indian 	Indians
Indonesia 	Indonesian 	Indonesians
Iran 	Iranian, Persian 	Iranians, Persians
Iraq 	Iraqi 	Iraqis
Ireland[k] 	Irish 	Irish, Irishmen/Irishwomen
Isle of Man 	Manx 	Manx
Israel 	Israeli, Israelite 	Israelis
Italy 	Italian 	Italians
Ivory Coast[l] 	Ivorian 	Ivorians
Jamaica 	Jamaican 	Jamaicans
Jan Mayen 	Jan Mayen 	
Japan 	Japanese
Jersey 	Channel Island 	Channel Islanders
Jordan 	Jordanian 	Jordanians
Kazakhstan 	Kazakhstani, Kazakh 	Kazakhstanis, Kazakhs
Kenya 	Kenyan 	Kenyans
Kiribati 	I-Kiribati 	I-Kiribati
North Korea 	North Korean 	Koreans
South Korea 	South Korean
Kosovo 	Kosovar, Kosovan 	Kosovars
Kuwait 	Kuwaiti 	Kuwaitis
Kyrgyzstan 	Kyrgyzstani, Kyrgyz, Kirgiz, Kirghiz 	Kyrgyzstanis, Kyrgyz, Kirgiz, Kirghiz
Laos 	Lao, Laotian 	Laos, Laotians
Latvia 	Latvian, Lettish 	Latvians, Letts
Lebanon 	Lebanese
Lesotho 	Basotho 	Basotho (singular Mosotho)
Liberia 	Liberian 	Liberians
Libya 	Libyan 	Libyans
Liechtenstein 	Liechtensteiner 	Liechtensteiners
Lithuania 	Lithuanian 	Lithuanians
Luxembourg 	Luxembourg, Luxembourgish 	Luxembourgers
Macau 	Macanese, Chinese
North Macedonia, Republic of 	Macedonian 	Macedonians
Madagascar 	Malagasy 	Malagasy
Malawi 	Malawian 	Malawians
Malaysia 	Malaysian 	Malaysians
Maldives 	Maldivian 	Maldivians
Mali 	Malian, Malinese 	Malians
Malta 	Maltese
Marshall Islands 	Marshallese
Martinique 	Martiniquais, Martinican 	Martiniquais/Martiniquaises
Mauritania 	Mauritanian 	Mauritanians
Mauritius 	Mauritian 	Mauritians
Mayotte 	Mahoran 	Mahorans
Mexico 	Mexican 	Mexicans 	"Aztecas", "Mexas"
Micronesia, Federated States of 	Micronesian 	Micronesians
Moldova 	Moldovan 	Moldovans
Monaco 	Monégasque, Monacan 	Monégasques, Monacans
Mongolia 	Mongolian 	Mongolians, Mongols
Montenegro 	Montenegrin 	Montenegrins
Montserrat 	Montserratian 	Montserratians
Morocco 	Moroccan 	Moroccans
Mozambique 	Mozambican 	Mozambicans
Myanmar[m] 	Burmese 	Burmese, Bamar
Namibia 	Namibian 	Namibians
Nauru 	Nauruan 	Nauruans
Nepal 	Nepali, Nepalese
Netherlands 	Dutch, Netherlandic 	Dutch, Dutchmen/Dutchwomen, Netherlanders
New Caledonia 	New Caledonian 	New Caledonians
New Zealand 	New Zealand 	New Zealanders 	"Kiwis"
Nicaragua 	Nicaraguan 	Nicaraguans 	"Nicas", Pinoleros
Niger 	Nigerien 	Nigeriens
Nigeria 	Nigerian 	Nigerians 	"Naija"
Niue 	Niuean 	Niueans
Norfolk Island 	Norfolk Island 	Norfolk Islanders
Northern Ireland 	Northern Irish, British 	Northern Irish, Northern Irishmen/Northern Irishwomen, British
Northern Mariana Islands 	Northern Marianan 	Northern Marianans
Norway 	Norwegian 	Norwegians
Oman 	Omani 	Omanis
Pakistan 	Pakistani 	Pakistanis
Palau 	Palauan 	Palauans
Palestine 	Palestinian 	Palestinians
Panama 	Panamanian 	Panamanians 	"Canaleros", "Istmeños", "Panas"
Papua New Guinea 	Papua New Guinean, Papuan 	Papua New Guineans, Papuans
Paraguay 	Paraguayan 	Paraguayans 	"Guaraníes"
Peru 	Peruvian 	Peruvians 	"Incas"
Philippines 	Filipino, Philippine 	Filipinos/Filipinas 	"Pinoys"
Pitcairn Islands 	Pitcairn Island 	Pitcairn Islanders
Poland 	Polish 	Poles
Portugal 	Portuguese 	"Tugas"
Puerto Rico 	Puerto Rican 	Puerto Ricans 	"Boricuas"
Qatar 	Qatari 	Qataris
Réunion 	Réunionese, Réunionnais 	Réunionese, Réunionnais/Réunionnaises
Romania 	Romanian 	Romanians
Russia[n] 	Russian 	Russians 	"Russkis" "Soviets"
Rwanda 	Rwandan 	Rwandans, Banyarwanda
Saba 	Saba 	Saba Dutch
Saint Barthélemy 	Barthélemois 	Barthélemois/Barthélemoises
Saint Helena, Ascension and Tristan da Cunha 	Saint Helenian 	Saint Helenians 	"Saints"
Saint Kitts and Nevis 	Kittitian or Nevisian 	Kittitians or Nevisians
Saint Lucia 	Saint Lucian 	Saint Lucians
Saint Martin 	Saint-Martinoise 	Saint-Martinois/Saint-Martinoises
Saint Pierre and Miquelon 	Saint-Pierrais or Miquelonnais 	Saint-Pierrais/Saint-Pierraises or Miquelonnais/Miquelonnaises
Saint Vincent and the Grenadines 	Saint Vincentian, Vincentian 	Saint Vincentians, Vincentians 	"Vincy"
Samoa 	Samoan 	Samoans
San Marino 	Sammarinese
São Tomé and Príncipe 	São Toméan 	São Toméans
Saudi Arabia 	Saudi, Saudi Arabian 	Saudis, Saudi Arabians
Scotland 	Scottish, British 	Scot, Scotsmen, Scotswomen, na h-Alba
Senegal 	Senegalese
Serbia 	Serbian 	Serbs, Serbians
Seychelles 	Seychellois 	Seychellois/Seychelloises
Sierra Leone 	Sierra Leonean 	Sierra Leoneans
Singapore 	Singapore, Singaporean[2][3] 	Singaporeans[2][3]
Sint Eustatius 	Sint Eustatius, Statian 	Statians
Sint Maarten 	Sint Maarten 	Sint Maartener
Slovakia 	Slovak 	Slovaks, Slovakians
Slovenia 	Slovenian, Slovene 	Slovenes, Slovenians
Solomon Islands 	Solomon Island 	Solomon Islanders
Somalia 	Somali 	Somalis
Somaliland 	Somalilander 	Somalilanders
South Africa 	South African 	South Africans
South Georgia and the South Sandwich Islands 	South Georgia or South Sandwich Islands 	none
South Ossetia 	South Ossetian 	South Ossetians
South Sudan 	South Sudanese
Spain 	Spanish 	Spaniards 	several, including "Castellanos", "Gallegos"
Sri Lanka 	Sri Lankan 	Sri Lankans
Sudan 	Sudanese
Suriname 	Surinamese 	Surinamers
Svalbard 	Svalbard 	
Swaziland[o] 	Swazi, Swati 	Swazis
Sweden 	Swedish 	Swedes
Switzerland 	Swiss 	Swiss
Syria 	Syrian 	Syrians
Taiwan 	Taiwanese
Tajikistan 	Tajikistani 	Tajikistanis, Tajiks
Tanzania 	Tanzanian 	Tanzanians
Thailand 	Thai 	Thai
Timor-Leste[p] 	Timorese 	"Maubere"
Togo 	Togolese
Tokelau 	Tokelauan 	Tokelauans
Tonga 	Tongan 	Tongans
Trinidad and Tobago 	Trinidadian or Tobagonian 	Trinidadians or Tobagonians 	"Trinis", "Trinbagonians"
Tunisia 	Tunisian 	Tunisians
Turkey 	Turkish 	Turks
Turkmenistan 	Turkmen 	Turkmens
Turks and Caicos Islands 	Turks and Caicos Island 	Turks and Caicos Islanders
Tuvalu 	Tuvaluan 	Tuvaluans
Uganda 	Ugandan 	Ugandans
Ukraine 	Ukrainian 	Ukrainians
United Arab Emirates 	Emirati, Emirian, Emiri 	Emiratis, Emirians, Emiri
United Kingdom of Great Britain and Northern Ireland 	British, UK 	Britons, British 	English, Englishmen/Englishwomen, Northern Irish, Northern Irishmen/Northern Irishwomen, Scots, Scotsmen/Scotswomen, Scottish, Welsh, Welshmen/Welshwomen
see Other words for "British"
United States of America 	United States, U.S., American[q] 	Americans[q] 	"Yankees/Yanks"[r]
Uruguay 	Uruguayan 	Uruguayans 	"Charrúas"
Uzbekistan 	Uzbekistani, Uzbek 	Uzbekistanis, Uzbeks
Vanuatu 	Ni-Vanuatu, Vanuatuan 	Ni-Vanuatu
Vatican City State 	Vatican 	Vatican citizens
Venezuela 	Venezuelan 	Venezuelans 	"Venecos"
Vietnam 	Vietnamese
Virgin Islands, British 	British Virgin Island 	British Virgin Islanders
Virgin Islands, United States 	U.S. Virgin Island 	U.S. Virgin Islanders
Wallis and Futuna 	Wallis and Futuna, Wallisian or Futunan 	Wallis and Futuna Islanders, Wallisians or Futunans
Western Sahara 	Sahrawi, Sahrawian, Sahraouian 	Sahrawis, Sahraouis
Yemen 	Yemeni 	Yemenis
Zambia 	Zambian 	Zambians
Zimbabwe 	Zimbabwean 	Zimbabweans 	"Zimbos"